1111111
1CC0001
10E0001
1P00001
1111111