111111111111
100000000C01
10P0C00C0111
10000C001E01
111111111111