1111111
1C0CC01
10E0001
1000001
1111111